############################################################
#                                                          #
#  #    ####  ####     ###   ##  ###  ##### ####  ####     #
#  #    #    #         #  # #  # #  #   #   #    #         #
#  #    ##    ###      ###  #  # ###    #   ##    ###      #
#  #    #        #     #    #  # #  #   #   #        #     #
#  #### #### ####      #     ##  #  #   #   #### ####      #
#                                                          #
#  ###  # #### #   # ### ##   #  ###  ####  ###  #    #### #
#  #  # # #    #   #  #  # #  # #   # #    #   # #    #    #
#  #  #   ##    # #   #  # #  # #     ##   #     #    ##   #
#  #  #   #     # #   #  #  # # #   # #    #   # #    #    #
#  ###    ####   #   ### #   ##  ###  ####  ###  #### #### #
#                                                          #
#  ###  #   #                                              #
#  #  #  # #                                               #
#  ###    #                                                #
#  #  #   #                                                #
#  #  #   #                                                #
#  ###    #                                                #
#                                                          #
#  #### #   #   #    ##   #                                #
#  #    #   #  # #   # #  #                                #
#  ##    # #  #   #  # #  #                                #
#  #     # # ####### #  # #                                #
#  ####   #  #     # #   ##                                #
#                                                          #
#  #   # ### ##   #  ###  #### ##   # ####                 #
#  #   #  #  # #  # #   # #    # #  #   #                  #
#   # #   #  # #  # #     ##   # #  #   #                  #
#   # #   #  #  # # #   # #    #  # #   #                  #
#    #   ### #   ##  ###  #### #   ##   #                  #
#                                                          #
#   ##  #### #    ####  #### ##### ### ##   #              #
#  #  # #    #    #    #       #    #  # #  #              #
#  #    ##   #    ##    ###    #    #  # #  #              #
#  #  # #    #    #        #   #    #  #  # #              #
#   ##  #### #### #### ####    #   ### #   ##              #
#                                                          #
#   ##  #    #### #   # #### ##   # ##### ### ##   # ####  #
#  #  # #    #    ## ## #    # #  #   #    #  # #  # #     #
#  #    #    ##   # # # ##   # #  #   #    #  # #  # ##    #
#  #  # #    #    #   # #    #  # #   #    #  #  # # #     #
#   ##  #### #### #   # #### #   ##   #   ### #   ## ####  #
#                                                          #
############################################################